#####  ######## #####             #####                   ######
#...## #......# #...#             #...#  ###### ###########....#
#....###.#....# #...#   ####### ###...####....###..............#
#....##..#....# #...#   #.....###......................####....#
#.......##....###...#   #.....#...#...###....####......#  #....#
#.....######........#   #.......###...# ##...#  #......#  ####.#
####.##    #######..#   #.....### #####  #...#  ########    #..#
   #.#           ##.### #####.#          #####              #.##
  ##.### ######  ##...# #####.####       ##############     #.# 
  #....# #....####....# #........#####   #.....##.....#   ###.##
  #....# #............# #.....##.....#   #.....##.....#   #....#
  #....# #....#####...# #.....###....#   #......#.....#####....#
  #....# #....#   #...# #.....# #....#   #......#..............#
  #....# #....#   #...# #.....# ##.###   #####........#####....#
  ##.### #....#   #...# #.....#  #.#         #.##.....#   #....#
   #.#   ###.##   ##### #######  #.#         #.#####.##   ######
####.## ###..## ########  ###### #.#       ###.#####.#          
#.....###.....# #......#  #....###.###     #...##....#     #####
#......##.....# #......####....##....#     #.........#######...#
#.............# #..............##....#     #...##.........##...#
#.....###.....###......####....##.>..#     ##############..#...#
#####.# #..............#  #....#######                  ##.....#
    #.# #.....###......#  ##.###                         ###...#
    #.# ####### ########   #.#                            #...##
    #.#                 ####.##################    ########.### 
#####.#           #######......##......##.....######...##...#   
#.....#       #####....##..............##.....##.......##...#   
#....##########........##......#.................###...#....#   
#...............####<..##......##......##.....#### #........#   
#...#####....####  #...###.######......##.....#    #....#...#   
##.##   ##...#     #...# #.#    #########.....##   #.########   
 #.#     #####     ##.## #.#            #####..#   #.#          
 #.#    ########   ##.####.#############    ##.#   #.#   ###### 
##.######......#   #...##......##......#######.#####.### #....# 
#.....##.......#   #...##..............##......##......# #....# 
#.....#........#   #...##.....###......##......##......###....# 
#.......#......#   #..........# #......##......##.......##....# 
#.....###......#   #...##.....# #########......##........#....# 
#.....# #......#   ######.....#         #########......#......# 
####### ########        #######                 ############### 