######################################
##############.#######################
###########.##.<.#####################
########..#.##...#####################
#########.........####################
##########........####################
###########......#####################
##########..O...#..###################
######.............###################
####.#..###.###..#.###..##########2.##
####.#.####.######......##########..##
####.#.#......###......##########....#
####...###......#......#..#####..$...#
#####...####....#....#.............###
##.....####........................###
###..######1.$........#........O.#####
###..#########....#####........#.#####
###..########..#######.......#...#####
####.########..######........#.....###
###....#######.######..##>..##....####
###....#######.######..###############
###......$..##..######################
###..#..........######################
####........###.######################
######...#############################
######.3.#############################
######..##############################
#######.##############################
######################################