+------------------+
|      |           |
|--- + |   -----+  |
|    |   $      |  |
| +  +------+   |  |
| |     | 1 |   |  |
| +---+     +---+  |
|     |            |
|--+  +------------|
|     |            |
|--+  |   +        |
| 2|  |   |   +----|
|  |      |        |
|  +------+---+    |
|             |    |
|    +----+   +    |
| 3  |             |
| +--|   +---------|
|    |            O|
+------------------+
