####################
######.##.....######
####...........#####
#.##..###.....######
#..........###<.####
#......#######..####
#.....#####.##.#####
#.......#.......####
#...............####
#.>.........#.######
#..........#########
#...........########
#...........########
######......########
####......#.########
#####.......########
#####.....##########
########..##########
####################
####################