####################
#......#...........#
####.#.#...######..#
#....#..........#..#
#.#..########...#..#
#.#.....#...#...#..#
#.#####.....#####..#
#.....#............#
####..##############
#.....#............#
####..#...#........#
#..#..#...#...######
#..#......#........#
#..############....#
#.............#....#
#....######...#....#
#....#.............#
#.####...###########
#....#............>#
####################