####################
###########...<....#
######.............#
######.............#
######............##
######....##......##
######....####.....#
#####.....###.#....#
#####.#.......#..>.#
###......#.##.#..###
###......#.##....###
####.##....#.....###
#####......##..#####
#####....###########
#####...############
#.###...############
#...#.##############
#......#############
###....#############
####################