######################################
##############.#######################
###########.##.<.#####################
########..#.##...#####################
#########.........####################
##########........####################
###########......#####################
##########......#..###################
######.............###################
####.#..###.###..#.###..##########..##
####.#.####.######......##########..##
####.#.#......###......##########....#
####...###......#......#..#####......#
#####...####....#....#.............###
##.....####........................###
###..######...........#..........#####
###..#########....#####........#.#####
###..########..#######.......#...#####
####.########..######........#.....###
###....#######.######..##>..##....####
###....#######.######..###############
###.........##..######################
###..#..........######################
####........###.######################
######...#############################
######...#############################
######..##############################
#######.##############################
######################################