####################
########..######...#
#######...##.##...##
#######...........##
#######...........##
#########.......#.##
#########.#.....#..#
#..#####...#......##
#.<..###.###......##
##........##......##
###.......##......##
####.....##........#
####.###..#......###
####.>.#........####
######......##....##
#######.######...###
##############..####
##############..####
##############..####
####################