########################################
###..################.....<...##########
##..#####.###########........###########
##..#####...##..###.#........###########
##..#.#.....#...###...........##########
#.....#.#...##......#..........#########
#............#..#..##.....#.#..#########
#......#........####...........####....#
#...........##...............###.......#
#..#....#...#..............#..##.......#
#......######.................#..#.....#
#....#..#......##...#...............#..#
#.......##....#####.............#...#..#
#..####.##...######.........#..###.....#
#...#.###....######....#......#####...##
###...###....#####.#####.....######...##
####..###..#####....####...#..####..####
####..####...##................#########
###########.....#....######.#..#########
########################################