1575 1445 100
20
####################
#......#.....#..#..#
#......#.....#..#.##
#......#...........#
###..###.........###
#..................#
#..................#
#......#...........#
#......#.....#######
#............#.....#
#............#.###.#
#............#.#####
#............#.....#
#............#####.#
#..................#
#............#.....#
#............###...#
#............#.....#
#..................#
####################